A-----------B
I...........|
I0000.......|
I.......0000|
I0000.......|
I.......0000|
I...........|
I....TTT....|
I...........|
I....TTT....|
I...........|
I...........|
C-----------D
