A-----------B
I...........|
I...........|
I.....#.....|
ITTTTT#TTTTT|
I.....#.....|
I.....#.....|
I..T..#..T..|
I.....#.....|
I.....0.....|
I..T.....T..|
I...........|
C-----------D
