A-----------B
IX.........X|
IX.........X|
IX.........X|
IX.........X|
IX.........X|
IX.........X|
IX.........X|
IX.........X|
IX.........X|
IX.........X|
IXXXX...XXXX|
C-----------D
