A-----------B
I...........|
I...........|
I..00.T.00..|
I...........|
I.....T.....|
I..00.T.00..|
I...........|
I.....T.....|
I..00.T.00..|
I...........|
I...........|
C-----------D
