A-----------B
I...........|
I..TT...TT..|
I..TT...TT..|
I...........|
IXXXXXXXXXXX|
IXXXXXXXXXXX|
I...........|
I...........|
I...........|
I...........|
I...........|
C-----------D
