A-----------B
I...........|
I...........|
I..XX...XX..|
I..XX...XX..|
I...........|
I...........|
I...........|
I..XX...XX..|
I..XX...XX..|
I...........|
I...........|
C-----------D
