A-----------B
I...........|
I...........|
I..XX...##..|
I..XX...00..|
I...........|
I...........|
I...........|
I..##...XX..|
I..00...XX..|
I...........|
I...........|
C-----------D
