A-----------B
I...........|
I.XX.....XX.|
I.X.......X.|
I...........|
I....###....|
I....###....|
I....000....|
I...........|
I.X.......X.|
I.XX.....XX.|
I...........|
C-----------D
