A-----------B
I...........|
I..##...##..|
I..00...00..|
I...........|
I..##...##..|
I..00...00..|
I...........|
I...........|
I..00...00..|
I...........|
I...........|
C-----------D
