A-----------B
I...........|
I...........|
I...........|
I...........|
I...........|
I...........|
I...........|
I...........|
I...........|
I...........|
I...........|
C-----------D
